..............
..............
.xxxxx...xxxxx
.x...x...x....
.xxx.x...xxx..
...x.xxx...x..
xxxx...x...x..
.......x...x..
.......x...x..
.......xxxxx..
..............
